+-+-+-+-+-+-+-+-+-+-+-+-+
| |     | |   | | |     |
+ + +-+-+ + +-+ + +-+ +-+
| |   | |   |       | | |
+ + +-+ +-+ + + + +-+ + +
| |   | |   | | |   |   |
+ + + + + + + +-+-+ + + +
| | |     |           | |
+ + + +-+-+ +-+ + +-+ + +
| |   | |     | |   | | |
+ +-+ + + + + +-+-+-+-+ +
|     |   | | |   |     |
+ +-+ + + +-+ +-+ + + + +
|   |   |   |   |   | | |
+ +-+ +-+-+ + +-+ +-+ +-+
| |     | | |   | |     |
+ + + +-+ +-+ + +-+ + + +
| | |       |     | | | |
+ + + + + + + +-+ +-+-+ +
| |     | | | |   |     |
+ + + + + + +-+-+ +-+-+ +
| | | | | |     | |   | |
+ +-+ + + + + +-+ + +-+ +
|   | | | | |   |     | |
+-+-+-+-+-+-+-+-+-+-+-+-+
