+-+-+-+-+-+
|     | | |
+ +-+-+ + +
|   | | | |
+-+ + + + +
| | |   | |
+ + +-+ + +
|     | | |
+-+ +-+ + +
|         |
+-+-+-+-+-+
